50 .x
 .         .                                                                            . .     .          .. .                      .                                                     .             
                      .              .      .          .        .        .                .                                    .                                         .                        .      
       .                       .          .                                     .       .                           .   .                    .      .                                      .        .    
.      .                                                           .      .                                                             .                                 .                              
                .    .  .               .      .       .                                  .   .          .          . .        .  .            .                             .    .                      
                  .              .     .            .                           .                     .         .                            ..                      .                                   
                                                                                     .      .        .               . .            .          .  .  .       .   .        .                              
                       .                            .        .                  .                            .      .   . .        .                      .                    .        .                
                                       .                                                  .                                      .  .      .            .         .                              .       
                             .           .                 .      .         .                 .        .                     .   .                          .    .                .    .         .       
                      .                   .          .                              .   . .          .                                  .                        .                                       
                              .     .                 .            .                                                .          .                        .   .                 .          .            .  
    .            .    .     .         .                                       .             .                          .                                       .                  .                      
        .         .            .                                        .                 . .                  .    .              .                       .          .             .                    
                                                                 ..      .          .  .     .                           .      .                            .       .          .                        
 .                               .         .    .             .            .          .   .          .          .                                                                ..                      
   .            .    .            .      .                   .               ..               .     .        .                               .    ..              .         .                  .         
                    .           .          .                .                                          .                      .                                                  .            .          
                             .                                       .                       .           .    .                                                                           .    .         
                                                                           .                            .      .                                                       . .                               
              .                     .                    .               .                   .                   .      .                                                            .    .   .     .    
 .                                                                                           .    ..                    .                               .                  .    .             .          
  .    . .               .        . .                        .       .                                                                    .                 .                     .     .                
         .                    .      .                                            . .                                                               .                                                    
            .                                    .                                                                                             .                    .                          .         
                                                  .                          .                                                   .                                              .                        
                 .. .                  . .              .          . .         .                                      ..   .                     .                          . .                   .  .   
               . .      .      .                 .          .  .           ..                                    .                    .                                                                  
          .            .             .                                 .       .            .     .                   .                       .        .                  .                       .      
                         .          .         .                                       .                                 .                                                                .               
                                .                     .        .        .     .       ..   .          .            .  .                            .     .           .                      .            
               .                                                      ..                                             .       .                              .                                        .   
  .  .                                                                .                            .                                               ..      .             .               .              .
                                         .      .                   .    .                                                                               .  . .                                          
        . .                .                                             .   .               .                .        .         .                                        .         .                    
   .       . .              .            .      .                         .               . ..          .          .             .                 .                                         .           
         .                   .           .         .                             .      .   .                           .                          .                                                     
                      .          .    .                .                     .                         .                                                         .                  .              .     
                            .                   .               .                       . .                        .                   .     .                                 .  .               .      
    .                                   .                           .         .        . .   .                                 .                                              .     .                    
      .                            ..     .             .     .         .        .                                             .                .  .                     .                               
     .      ..               ..     .                                           .      .                                 .    .             .           .           .               .       .            
                                          .                   .    .                  .                         .                                                         .         .  . ..      .   .   
.                        .            .       .             .  .                        .           .      .                                      . .                                               .    
  ..             .                                                  .                                               .                            ..                                                    . 
                           .    .      .   .                             .                   .     .                            . .   .       .   .                    .                           .     
        .    ..                                                             .                                   .     .        .                             .           .         .                     
               .         .   .                            . .            ..            .                                                                              .     .            . .    .        
                        .                                                        .                        .                                            .                             .                   
                                                                                    .                                                     .         .        .                 .                         
