51 .x
     . .                                                       .       .      .   .                                       .           .                        .                                     .                   .              
                        .  .                                                         .               .   .        .                                   .    .      . .                                        ..     .                   
                          . .         .        .                               .          .                                 .                               .                            .                     .               .        
                        .                             .                    .  .                        .                           .               .         .      .    .          .  .                             .                . 
                                                    .  .   .       .                              .   .                                          .     .       .                       .            .                .                 .
            . .  .                                   .                                         .   .            .  .                   ..                                   .   .                                  .                 .  
                                .                   .                         .    .                                 .                              .               .                      .      .      .                 .            
   .        .   .        .     .   .                                .                                   .               .                  .                        .  .                   .                      .         .  .        
               .             .                   .                               .          .   .                      .               .                         .         .                .                                           
           .              .    .                                  ..                    .              .            .                    .       .     .                                  .       .   .                   . .           
        .                     .          .                                                                         .               .                                      .                           .  .   .                  ..   .  
  .         .                                        .              .   .                .                   .                              .                                    .                  .                 .               . 
       .   .      .                          . .                               .                               .    .         .                         .          .        .    .                          .                           
              .                                         .                    .                               .          .                           .             .          .                         .                          .     
                         .           .         .  .     .   .          .               .         .                    .              .     .              ..       .                                     . .      . .       .       . . 
                           .             .       .                                       .                         .  .                     .     .      .                                                           .                  
                                                                ..                              .                                   .   .                                                              ..                               
        .     .   .        .   .                                               .     .                   .        .           .         . .                   .                                               .     .   .               
                   .          .      .     .              .       .                   .                       .    .                               .                                        ..            .              .          .   
      .                                                                                                                                    .                                .      .                  .                                 
                                                         .      .                     .    .         .     .                               .                                                                       .              .     
    .        .                          .                              .    .                    .   .     .   .                 .                      .                                                                               
             .                   .              .     .               .                    .         . .       .                                     .                   .   .   . .    .    ..     .                      . .  .  . .  
    .            .    .        . .                   . .      .          .        .             .          .                      .                      .                 ..       .    .                            .                 
                  ..      .                                .                                                       .      .          .           .       .         .             .                               .   .             .    
                                .                                                             .                                                                             .                                                           
.  .                .                                                                                   .                              .                                        .       .                   ..  .             .        .
                                                                                             .    .                     .                                                                               .                  .            
  .                                                   .      .                   .      . .                           . .                          . .     .                                                                            
.           .                          .            .                                       .                            .                                  .                                                                           
             . .                  ..                                                          .                                       .                  .                              .      .     .      .           .               
   .                  . .                 .                                  . .              .             .         .                .                                        .                                        .       ..     
    .   .        .      .                        .                .          .                      .    .            .                                     .         .        .          .             .  .                            
                                                  .                                             .             .  .                                                             .  .                                                     
                                         .                                             .                                                                                                                                .        .      
 .        .            ..                         .                       .             .                                  .             .                                               .   .                                    .  .  
                .      .  .                            .                   .                 .                                    .               .                 .                  .                 .                           .. 
      .  .           .                                              .              .        . .        .      .   .                           . .                                     .      ..     .                               .   
                                           .                                                                            .                                      .             .    .   .       .                                    .    
   .              .                                       .         .                                   .                    .              .                                .      .         .                             .           
                             .                      .     .                      .                                                       .             .     .                                 .               .         .              
 .                                                                           .                                                                     .                            .                                                  .    
                 .     .                     . .   .                                                              .                                       .                      .        .                                    .       .
                .           .                 .                       .     .                .                                                                 .                                                   .          .  .      
             .             .                .             .       .    .                                          .                                                                                         .                           
                                                                                 .                .  . .                    .      .         .     . .            .     .   .   .                                         .             
                       .                 . .                .                             .                  .                                   .       .        .                                                                     
                                                    .                    .   .      ..      .                        .               .           .            . .              .     . .            .     . .                           
                               .                      .                                                      .                                            .                                                                          .  
             .                                    .            .                                                                       .      .                                          ..                                      .      
                                         .                 . .         .            .. .     .             ..                                                   .                                                                       
