53 .x
                          .                                   .      ..  .                                                                     
      .      .                                                                                   .                                             
             .        .                               .                      .                   .                               .        .    
                                                                                                                                 .             
   .                            .                                                                              .                               
      .            .   ..     .                        .          .    .                                               .                       
      .                                                                                                                        .  .         .  
              .                              .       .        .  .      .    .          .    .                     .       .  .                
                                        .             .       .             ..           .  .                                .           .     
          .               .                       .            .                      . .                              ..  .                   
 .              .   ..                                                                                                                         
           .      .                     .                                      .   .          .                                                
  .  .     .      .        .                         .                                  .        .                 .           .            .  
                                .                   .                  .                              ..       .  .                            
                              .                                                             .                                 .                
                                                .                            .                               .            .            .       
 .  . .                    .        .        .              .                                                  .  .  .      .            .  .  
          .                .                                       .                                                                           
                                       .                                                                  .                           .  .  .  
      .                   .                        .            .              .        .       .           .      .                    . .    
                       .       .  .     .             .      .                                                          .      .    .     . .  
.            ..          .                   .                                                                               .                 
                                  .                                              .     .         .        ..                                .  
                                         .                  . . .                                            .                         .       
                                   .                                                .                                                          
             . .           .                                                              ...                                    .             
           .                .   ..      .            .          .             . .       .             .                        .               
                 .        .                                                           .                                .  .                    
                 .      .            . .                       ..               .                                           .    .             
                       .        ..                  .                     . .         .                                          .             
                      .     .                                            .                                  .       .                          
                                     .                   .     ..                          .            .       .                              
                        .      .                                         .          ..                   .                        . .   .    . 
                    .                    .          . .   .             .         .             .                                .             
 .        .                    .           .  .     .       .                                     .                                            
              .      .                                                        .                                                                
                                                         .                 .     .  .      .            ..      .                              
   . .       .                 .              .  .                     .             .                                  .            .     . . 
 .   .        .                                                       .                                                  .            .        
   .                  .         .               .       .   .                                 .          .                              .      
.                              ..    .                         .           .                                        .                          
                   .             .       .                      .            .        .         .               .  .          .  .        .    
                               .             .                  .      .            .    .         .                                      .    
                          .  .                                     .                           .  .                 .                     .    
                 .                     .        .  .   ..                                       .                    .                         
                                 .      ..                     .                                            .              .  .                
.                                                 .         .              .                       .                         .      .          
        .    . .       .                                             .      .          .                                     .                 
                                                                                             .    .        .                                 . 
     .             .             .                                  .  ..                             .             .                          
       .                ..                 .          .                                   .              . .                   .      .        
                                                                                .             .                      .                        .
  .           .                                                               .                        .                                     . 
