54 .x
                                                          .              .                                    
                                   .  .                                 .                                     
                    .                                                                                    .    
                                                                       .                          .    .      
                .           .  .              .    .                                                          
                                  .                                            .                              
         .  .                                        .              .                            .            
                           .         .     .     . ..         .                           .    .              
                                                   .               .     .   .                                
          .                      .                                    .  ..                       .     .     
        .                  . .                                                                    .           
                           .  .       .     .      .          .                . .                      .     
      .                                     .          .      .            .                .                 
                          .         .                                           .                 .           
                            .               .                     .                                          .
                                      .                                                               .       
  .                       .                                 . .     .                    .    .  .           .
         .   .                     . .              .                                    .  .                 
.                                                                   .                                         
                                 .               .                      .                 .                  .
                        .                                                                                     
                  .    .                             .                 .   .           . .                    
 .                                ..                          .                                       .       
     .            .                                                                 .          . .    .       
                                  .      .                     .        .    .                                
            .  ..                 ..                          .                                               
                     .                           .                            .                           .   
                         .                                                  .              . .   .         .  
  .                             .             .    . .                          .                             
     .   .                             .      .                    .                                  . .     
        .                                                         .               .                 .         
    .           .                 .                                 .                                         
   .                                   .                                       .                ..     .      
                                             .                                                                
    .                            .                .                 .        .      . .       .    .        . 
  .                         .                            .                                                    
      .  .                   .             .          .    .              .    .                              
                        .    .                 .            . .                          .      .             
  .         .                                                                                               . 
   .                               .       .       .                   .                           .          
  .  .        .                            .      .                     ..     .                              
        .            .                                     .                   .                              
                                                                        .                                 .   
.                                    . .               .                                                  .   
                         .  .     .                          .                                                
         .         .  .       .  .            .            . .                                       .        
  .        .                 .                                                      .    ..    .              
               .                                                               .      .                     . 
      .         ..           .      . .    .   .  .                 .            . .     .   .                
          .                                         .                   .         .                     .     
        .                         .      .        .                              . .     .     .      .    .  
                     .   .                      .                                                       .  .  
                                              .                        .                                      
              .                   ..            . .             .                           .                 
